###########
##a#####d##
###e###g###
####b#c####
#####f#####
###########
###########
###########
#####C#####
####BAD####
###########
###########