###########
#_________#
#_________#
#_________#
#___#_#___#
#_________#
#_________#
#___#_#___#
#_________#
#_________#
#_________#
###########